11111111111111111111
70000000000000000001
11111111111111111101
11110000001111111101
11114111101111111101
11110111100001111001
11110111111100000011
11110111111111111111
11110111111111111111
